WIDTH=20
HEIGHT=15
# Légende:
# # = mur
# . = pac-gomme
# o = power pellet
# P = spawn pacman
# G = spawn ghost
#   = vide

####################
#..................#
#.####.####.####..#
#o#  #.#  #.#  #.o#
#.####.####.####.#
#..................#
#.#.##########.##.#
#.#.....P........#.#
#.#.##########.##.#
#..................#
#.####.####.####.#
#o#  #.#  #.#  #.o#
#.####.####.####.#
#.......G..........#
####################